*X*****X****X*******X*****X*X*XX**X***X*********XX**X********X********X****X*X*X***X***X****X***X***
**X*XX***XX**XXXXXX***X*XX*******X**X***X*XXX*X****X**X*X*XX*X*X*XXX*X**X*X****X*X***XXX*XX***X**X*X
X*X***XX*XXX******X*XX**XX*XXXX*X**XXXX**X***XXXXXX**XX**X*X*X*X***X***XX*X*X*XX**X*X****X*XX*X*X***
**XXX**X**XXXX*XX*X***X****X**X**X**X**X***X**X***X*X**X*X***X*X*X**XXX***X*X*X**X**X*X*X**X**X***X*
*X**XX**X**X**X***X*X**X*XXX*XXX**X**X**XXX*X***X***X*XX**X*X***X*X*X***XXX*X***X*X***XX**XX*X*X*X**
**X**XX**X**X**X*X*X**XXX****XX*X**X**X***X**XXXXXXX****X**X*XX***X**X*X****XX*X***XXX***X***X**X*X*
X**X***X*XX**X***X*X*X*X**XX****XX**X**XX***X***X****XX**X*X***XX**X**X**X*X**X**X****X*X**XX**X**X*
*X*X*X*X**XX*X*XX********XX*XX*X***X*X***X*X**X**X*XX**X*X**XX*X**X*X**X**XXX**XXX*XX***X*X*X*X**X**
*X**X****X***X***X*XX*XXX*****X**X*X**XX*X**X**X***XXX***XX**X***X**X*XXX**X*X*****X**XX**X*****X**X
**X*X*XXX**XX*XX**XX*X****XX*X**X****XX**XX*X*XXX*X*X**XX*XX**XX***XX**X*X*X**X*X*X*X**X*X**XX*X**X*
*X**X***X*X*X***X*X**X*XXX***XX**X*XXX**X******X**X***X*****X***XX*X*X***X*X*X***X***XXX**X***X**X**
*X*XXX*X**X***X*X*X*X**X**X*X*XX**X****X**XX*X*X*XX*XX**XX*X*X*XX**X**XX*X*X***XX**X*****X*X*XX*XXX*
*X**XXX**X**XXX*X*****X**X**X**XX*X*XXXXX*X*X*X**X***X*X***X*X****X**XX**X**X*X***X*X*X*X****X***XX*
**X**XX*X**XX****X*XXX**X**X*X****X****X**X***X*X**X*XX**X***XXXX***X***XX*X**X*X*X**X*X*X*X***X****
*X*X****X*X***XX**X***X**X*X***X*X*XX*X**XXXX*X*X*X***X*X*X*X****XXX**XX***X*X**X**X******XX*X**XXX*
****XXXX*X**XX*XX*X*X**X***X*X*X*X*XX**X**X***X**X*XX******X**XX*X***XX**XX**X*XXX*X*X*XX***X**X***X
*XX********X****X**X**X**XX*X**X******X*X***X**X*****X*X*X*X*XX****XX***X***XX**X*X***X**XX*X*X**X*X
***XX*XX*XXXX*X**X*X*X*X*X***X**XX*XXX**XXXX**X*XXXX**X***X**X**XXXXX*XX**X***X****X*X**X***X**X*X**
*X***X***X*X**X*X**X***X**XX*XX***X***X******X******X**X*X**X**X***X**X*XXX*X*XXXX***X*X*X*X*XXX**X*
**X*X**X*X***X**X*X**XX*X*X***XXX***X*X*X*XXX*X*XXXXXX*X*X*X*XXX*X***X*****XX****XXXX****X******X*X*
*X***X**X**XXX*X***X*X**X*X*X****XXX**X*XX******X***XX*X*X********XXXX*X*X*X**XX******XX**XXXXX***X*
X**XX*X**XX****X*XX****XX**XX*X*X**X*XX***X*XX*X**X****X*X*XXX*XX*X***XX*X*XX***XX*XX**XXXX****XXX**
**X****X*X**X*XX*X**XX*X*X***X****X**X*XX*X***X**X*XX*X***X***X*X*X*X****X***X*X***X**X*****XX***X*X
*X*X*XX**XX*XX***X*X*X***XXX*XX*X***X******XX*X*XX***X**X*X*X*X*X***X*XXX*XX*X*X*XX**X**XX*X**X*X***
*X****X*X******XX**X**XX***X***XX*X*XX*X*XX***X****X**X**X**X*X**XXX*X**X**X*XX**X**X**XX****X*X**X*
*X*X*XX**X*X*XX***X*X***XX**XX***X****X*****X**XXXX**X*X*X*X**X*XX*****X**XX***X**XXX*XX**XX*X***X**
**X****X*X**X***X*X**X*XXX*X**XX*X*XX**XX*X**XX*****XX***X*X*X*****X*X***X**XX**X*****X**X**X**XXX*X
X***X*X**X*X**XX**X*X***X****X*X**X**X*XXX*XX***XX*X***XX**X**XX*XX*XX*X**X****X**X*XX**X*X*X*X****X
*XX**X**X***X***X*X***X*X*X*X***X*XX****X*****XXX*X**XX*X*X*X**X******X*XX**X*X**X*X**X*****X**X*X**
*X*X*X*X**XX**XXX*X*X*X****X**X*X**XX*X***X*XXX****X****X*X**X*XX*X*X******X**XX****X**X*XX**X**X**X
*****X*X*X***X****X*XX*X*X***X***X***X**X**X****XX**X*X*X***XX***X***X*XXXX**X**XXX***X**XX*X*X*XX**
*X*XX**X*X*XXX*XXXX*****XXX*X**X**XX**X**X*X*XXX*X*X*X***XX*X**X*X*X**X****X**X****XX**X***X**X***X*
*X**X*X***X****X***XX*X**X*X*X**XX**X*XX**X**X***X*X***X*X**X*X***X**X**XX*X*X**XX**XX**XX***XXXX*X*
**X*X*X*X***XXX**X*X*X**X*****X****XX**XX**X**XX*X**X*X**X*XXX**X*XXX**X***X**X***X**X*X**X*X*X***X*
X**X**X*XX*X****X**X*X*X**XXX**XXX***X***X**X*X***X**X*XX***X**XX***X*X**XXXX*X*X**X*****X****X*XX**
**XX*X****X**XXX**X**X**X****X****X*X*XX**X*X*X*X***X****XX**XX**XX***X*X**X**X*XXXXXXX*X**XXX***X*X
*X***XXX*XX*X****X**X*X**X*X**XXX**X*****X*XX**X*XX***XX***X***X**XXXX**X*X**X*X***X***XX*X***XX*X**
*X*XX***X***X*XXX*X*****X*X**X***X***XXXX****X*X***XXX**XX**XX**X****XX*X**X*X***X***X****X*X****X*X
X**X**X***XXX*****X*XXXX****XX*X*X*XX*****XX*X***X****X***X***X**X*X****X*XX**X*X**X*XXX*XX*X*XXX***
**X**X*XXX***X*XX*X****X*XXX***X**X***XX*X*X*X*XX*XXX*X*X**XX**X*X**XX*X**X**X**X*X*X***X***XX***XX*
X*XX*X*X***X*X*X**X*XX*X****XX**X*X*XX***X***X****X***X**X*X**X***X*X*X*X*X*X**XX*X***X***XX***X***X
X******X*X*X*X*X*X*X***XXXX*X*X*X*****X*X**X*X*XXX**XXXX*X*X*X*X*XX*X*****X***X***X*X*XXX**X*XX*XX**
**XXX*XX**X**X*X*X***XX***X*X*X*X*XXXXX**XX**XX***X***X**X***X***X**X*X*X**XXX**X*X**X***XX**X***XX*
*X***X***X**X*X**X*XXX*X*X**X****X*****X*X**X***X*X*X*X*X*X*X**XX**X**X**XX****X*X**X**X**X*X**XX***
**XX*X*XX**X****X**X*****XX**X*X**X*XX*X**X***XX**XX**X*X**X**XX*X**X**X**X*XXX****XXX*X*X**X*X*X*X*
X****X**XX***X*X**X**XX*X***X**X*X**X***X**XXX*XX***X*X*XX***X****X*XX**X*X***X*XX**X**X*X*X****X*X*
*XXX**X***XXX**X*X**XXX*X*XXX*X***X**X*XXX*X*****XX***X**X*XX**XX*X**XXXX***XXX**X*X**X**X*X*X*X**X*
*X**X**XX***X*X****XXX**X****X**XX**X***X****X*X**XXXX*X*X*X*X**X**X*****XXX***X**X**X*X***X**X**X**
***X**X*XXX**X**XXX*X**X*X*X**XX***X**X**X*XX***X****X*X***X*XX*X*X*XX*X*****X**X**X****XXX**X**X**X
*XX**X*****X**XXX***X*X***XXX**X*XX*XXXX*X***XXX**XX*X**X*X******X****XXXXXXX*X**X**XX*XX***X**X*X**
***X*X*XXX*X*X***XX****XX**X*X*X******X***X*X***X*X**X*X*X**X*XX***XX**X******XX*X*X*X****XX**X***X*
*X***XX****X***X**XXXX***X***X*X*X*XX**XX**X**X**X**X*****X*XXX**XX**X**XXX*XX***X*X*XXXX**X*X*X*X**
**XXX***X*X*XXX**X***X*X**X*X**X*XX**X***X***X*X***X**X*X**X****XX*X***X****X**X*X********X**X****X*
X*X***X*X*X****X***X**XX*X***X*X***X**XX**XX*X**X*X**X***X***XX*X**XXX***XXX**X*X**XXXX*XX**X**XX***
**X*XXX*X***X*X*XXX*X*X**X*X*X*X*X***X*X*X**X**X*X**XX*X*XXX**X***X***X*X****X****X****XX**X*X*XXXXX
*X*X*****XXX**X*X*****X*X**XXX**X*XX*X*X**X***X****X****X***X**XXXX*X*XX**XXX*XXX***XXX***X**X**X***
***X*X*XX***X***X*XX*X***X****X*X*******X*XXX***X*X*XX*X**X**XX*****X***X***X****X*X****XX**XXX***X*
X*X***X***X*XX*X****X*XX**XXX*X**X*XX*XXX****XXX**X****X*X*X**X*XXXX**X*XXX***XX**X**XXX**X*XX*X*X**
X*X*XX**XXX***X**XXX***XX*****XX*X**XX***X*X*X***X*XX*X**X**X*X*X***X*X****X*X**X***XX***X******X**X
**X****X***XX*X*X****X***X*X*X***XX**X*X**X**X*XX****X*X**X*X*X**XX**X*XX*X*X*X**XXX***XX**X*XX*X*X*
*XXX*XX**XX*X*X***XX**XX*X**X**XX**X*X**X*X*X*****XX****X***X**X*XXX****X*X***XX*X*X*X*X**X****XX***
**X**X**X******XX***XXX***X**X*X**X**X*X**X**X*X*X**XXX*X*X**X*X**XXX*X*X***X**X*****X**X*X*X*X***X*
X**X***X*X*XXX*X*X*X***XX*X*X**X*XX*X***X**X**XX***X**X****XXX**X**XX**X*X*X**X**X*X**XX**X*X*X*XX*X
*X**XXX******X*X**X**X**X*X*X*X**X***X*X*X**X*X**X**X**XXXX****XXX***X***X**X**XX**X*X***X**XX**X***
***X***XX*XX*X*XX*X*X*X***X*X**X*X*X*X*X**X***X*X*X***X***X*XX**X*XX**X*X*X*XX****X**X*XX*X**X*X*XX*
X*X**X*X**X**X****X*X**XXX**XX*X***XX**X*X*X*X*****XXX**X***X*X*X***X*X***X***X*X*X*X**X***X***X****
****X***X*X*X*X*X*X**X****X**X**XXX***X****X*X*X*XX****XXX*X**X*XX*XX**X*X*XX**X*X***X***X**XXX*X*X*
*XXX**XX**X*X*X**X**X**XXXXX**X*****XXXX*X**X**XX***XXX*X**XX******X**XX*X****X***XX**X*X**X**X*X**X
X****X***X**X*XX*X*XXX****X**X*XXXXX**X***X**X**X*XX******X**XXXXXX**X***X*XXX**X***X**X*X**X****X**
**X*X*XXX**XX****X**X**XX**X*X*******X**XX**X*X*X***XX*XXX**X*****X*X**X*X*****X*XX**X***X*X*X*X**X*
*X*X*****X*X**XXXXX**X***X*X*XXX*XX*X**XX**X**X*X*X*X******XX*X*X*X**X*X**XX*XX***XX**X*X**X***XX***
****XX*X*X*X*X***X**X*XX*X*X****XX****X***X**XX**XX**XX*XXXX**X*X*X*X***X***X*X*X***X*X**X*XX*X***X*
XXX*X**X***XX**X***X***X*X**XXX****XXX*X*X*X***X***X*X*X*****X*X**X*XX*XX*X******X*XX**X*X**X*XXXX**
**X**X**X*X***X*XXX**X***XX****XXXX****X*X***X**XX*X*****XXXX**X*XX**X***XXX*XXX**X***X*X*X*X*****X*
X**X***X*X**XX**X***X*XXX***XX****X*XX*X*XX*X**X*X**XXXX******XX*X**X**X**XXX****XX*X*X*****XXXXX*X*
**XXX*X****X***XX*XX**X***XX*XXXX*X*X**X****X*X***X*X***X*XXXX***X*X**X*X**X**X*X***X*X*XXXX****X*X*
*XXXX**XX*X*XX*X**X*X*X*XX********X*XX**XXXX***X*XX**XX**X*****XXX**X*X*XX**XX**X*X*X*X*X****XX*X*X*
**XX*X**X****X**X*****X**XX*X*X*XX****XX***X*XX****X***X*X*XX*X***X*X*X***X***X*X**X**X*X*XX**X***X*
X*****X**XXX**X**X*XX**X***X*X**X*X*X**X*X***X**XX**XX***X**XX**X***X**X*X*XX**X*X**XX**X*XX*X*XX**X
*X*X*X**X***X**X**X*XX**XX****X****X**X**XX*X**X*X*XX*XX**X****X*XXX**XX****XX***X*X***X*X***X***X**
***X*X*X**X**X**X****XX*X*XXX**XXX*X*X**X**X*X*X******X*X**XXXX**X*XX****XX**XX*XX*X*XX****XX**XXX*X
*X*X*X**X**X**X**X*X****X****X***X***X*X*X***X*XX*XXX***XX*X**XX*****XX*XX**X***X**X*X*XX*X***X*****
X**X**X*X*X**XXX**X**X*X**XX**XX**XXX**X***X*X***X***XX**X**X****X*X*X*X***X**XXX*X**X****X*X*X*X*X*
**X**X**X**X**X**X**X*X**X**XX*XX****X*XX*X**X*X*X*X*XX*XXX**X*X**XX*****XXX*X****X*X**X*X**X*X**X*X
*X**X*X*XX**X**X*X*X***X***X*****X*X****X**X*XX**X*X*****XXX**X*X***X*XXX****X*XX*X*X*X**X*X**XX*X**
*XX***X***X*X*X**X*X*X***X*X*X*X**X*X*X*X*X*****X*X**X*X**X**X***XX*X****X*X*X***XX**X**X*X**X***XX*
***X*XXXX***X*X*X***X**X**X***X**X***X****X*XX*XX***X*X*XX**X**X**X**X*X*X*X**XX***X***X****X**XX***
*X*X**X**XXX**X**XX**X*XX***X*X*X**X**XXXX*X**X***XXX******XXX**X**X**XXX***X***XX**XXXX*X*X**X***X*
XX**X*X*X**X*X*X***X*X**X*XX*XX***XX*X******X**XX*X***XXX*X*XX*X*X**X**X**X**X*X**X*X****X*X*X**X*X*
***X**X***X**X**XX*X**X**X*****X*X***X*X*XX*XX****X*XX***XX****X**X**X*X*X*X*X**X*X***X*X**X**X*X**X
*XX*X**X*X**X*X**X**X**XX**XXX*X**XXXX**X*****XXXX**X**X***X*XX**X**X**X****X**X***XXX*X**X*X**XXX**
**X***X**XX*X***X**XXX****X*****X*X***X**X*X*X***X*XX*X*XX*X***X***X**X*X*X**X*X*X*****X*XX**X*XXXX*
X**X*X**X***XX*XX*X*X**XXX**X*X*X*X*X**X**X**X*X*X****X**X*X*X**X*XX*X***X*X**X***X*XX*X****XX**XX**
X*X****XX*XX*X*X**X***X***XX***X**X*X*X*X*X*X**X*XXXXXXX***XX**X**X**X*X****X***X*X**X*X*XX***X****X
**X*XX*X**X****X*XX*XX**X***XX***X**X***X*X**X*X******XX*XX***X*X**XXX*X*XX**XXX***X**XX**XX*XXXXX**
*XX*XXX**X**X*X**X**X*X*XXX*X**X*X*X**XX**XX****XX*XXX***X**XX**X*X*****X**X****X*X*X*X*X**X**X****X
*X***X**X*XXX**X**X*X*X***X**X**XX*X*X***X*XXXX*X**X***XX**X***X****XXXX**X*X*X*X***X****X*X*X**X*X*
**X*XX*X******X*X*X***X*X**X**XX***X*XX*X******X**X**XX***X*X*X**XXX*****X***X***XXX**XX*X**X**X*X**
X**X*****XXXX*X*X*XXXX***XX*X*XX*XXX****XXX*XX**X*X*X***XX*****XX****XXXX**X*X*XX***XXX***X**X*****X
XX***XX*X*******X******X****X*******X*X*******X*X*****XX***X*X****XX******X*******X*****X**X***X*X**
