*X*****X***
*X*XXX*X*X*
***X*X*X*X*
XXXX*X*X*X*
*****X*X*X*
*XXXXX*X*XX
*******X***
*XXXXXXXXX*
***X*****X*
XX*X*XXX*X*
*****X*****
